1111111111111
1PEC011111111
1100000000001
1111111111111
